11111111111111111111111111111111111111
10000000001000000001000000010000000001
10111011101011111101011111010111011101
10111011101011111101011111010111011101
10200001101011110000000000000000000001
10111100000000000111110101111101011101
10000101111110100001000100010001000001
11110100001000101101011111010101011111
11110101101011100000000100010101011111
11110101000000101100010101000101011111
00000001011110101000010101110100000000
11110100010000001111110000010001011111
11110101110111101111110111011101011111
11110100000000100000000100000001011111
11110101111110101111110101111101011111
10000000010000000010000000010000000001
10110111010111111010111111010111011101
10010000000000000000000000000000010001
11010010111110101111110101111101010111
10000010001000100010000100010001000001
10111111101011111010111111010111111101
10000000000000000000000000000020000001
11111111111111111111111111111111111111
11111111111111111111111111111111111111