juuuuuuuuuuuuuuuuuuy
k000000000000000000z
k000000000000000bf0z
k000000000000000cg0z
k000000000000000dh0z
k000000000000000000z
k000000000000000bf0z
k000000000000000dh0z
k000000000000000000z
k00000000000000psqqq
k000000000000000000z
k000000002000000000z
k000000003000000000z
k000000ps4s90000000z
k000000005000000000z
k000000006000000000z
k000000000000000000z
k000000000000000000z
k000000000000000000z
xaaaaaaaaaaaaaaaaaao